WWWWWWWWWWWWWWCCWWWWW
WC   A      C      PW
W   EE  WWWWWWWWWWWWW
W E    CC        AC W
WWWWWWWWWWWWWWWW C  W
WC           CWW EC W
W    WWWWW E        W
W E  WWWWWWWWWWWWWWWW
W   CCC             W
WWWWWWWWWWWWWWWW   WW
W          A        W
W  E CWWWWWWWW     EW
W        WWWWWWWWWWWW
WWWW E   CCCCCCCC  TW
WWWWWWWWWWWWWWWWWWWWW