WWWWWWWWWWWWWWCCWWWWW
WC   A      C      PW
W   E   WWWWWWWWWWWWW
W E    CC         C W
WWWWWWWWWWWWWWWW C  W
WC           CWW  C W
W    WWWWW          W
W E  WWWWWWWWWWWWWWWW
W   CCC             W
WWWWWWWWWWWWWWWW   WW
W                   W
W    CWWWWWWWW     EW
W        WWWWWWWWWWWW
WWWW E   CCCCCCCC  TW
WWWWWWWWWWWWWWWWWWWWW