WWWWWWWWWWWWWWCCWWWWW
WC   AE     C      PW
W   E   WWWWWWWWWWWWW
W E    CC   E    AC W
WWWWWWWWWWWWWWWW C  W
WC           CWW  C W
W    WWWWW E        W
W E  WWWWWWWWWWWWWWWW
W   CCC   E         W
WWWWWWWWWWWWWWWW   WW
W   E      A        W
W    CWWWWWWWW     EW
W        WWWWWWWWWWWW
WWWW E   CCCCCCCC  TW
WWWWWWWWWWWWWWWWWWWWW