WWWWWWW  WWWWWWWWWWWW
W  WCWCCA           W
W E   WWWWWWWW   E  W
W   W      E        W
W  W WWWWWWWWWWWW   W
W  W       WCC   E  W
W  W  WCECCWWWWWWW  W
W  W  WCCCTW        W
W  W  WWWWWW    WWWWW      
W  W  WC WWWWW      W
W    W CWCC  WW     W
WCCE A WAW     E    W
WWWWWWW ECWWWWWWWWW W
WP            AA  CCW
WWCCCWWWWWWWWWWWWWWWW