WCWWWWW  WWWWWWWWWWWW
T  WCWCC   E        W
W E   WWWWWWWW      W
W   W               W
W  W WWWWWWWWWWWW   W
W  W    E  WCC   E  W
W  W  WCCCCWWWWWWW  W
W  W  WCCCCW        W
W  W  WWWWWW    WWWWW      
W  W  WC WWWWW      W
W     WCWCC  WW     W
WCCC  E WW     E    W
WWWWWWWWCCWWWWWWWWW W
WP         E      CCW
WWCCCWWWWWWWWWWWWWWWW